11111111111111
1P100001C10001
10101101010101
10101101010101
100001000101C1
11110101110111
10000100000001
10110111011101
101C0100010001
10111101010101
1C1C00010001E1
11111111111111
