111111111111111111
1P100001C000000001
1000010111111001C1
101111010000100111
10000001C110000101
101101011011101101
101C01000001000001
111001110101101101
10100000C101001C01
101101111101011111
1000000100000000E1
111111111111111111
