11111111111111111
1P000100001000001
111011101010111C1
10100000101010111
10001011100010001
1011100C111110101
101C1011100000101
10101010001111101
10001011101000001
11111000101011101
1C1011101010001C1
10100010101110111
10101000101000001
10101111101011111
100000000C10000E1
11111111111111111
