1111111111111111111111111111111111111111
1P00100100001000011C000100000100C1100001
10111001110110000C1111011000010111000001
10000000000000011110010000000101000010C1
1111000000100000000000010011110000001111
1C01010100111111010001110010011111001001
1100010110010001110001000010000001000001
1111110010010000100001C00110011001110001
1100000110000011101001111100001000000001
1000000000000000001000000101111011011001
1011111001110111001010010000100001001111
101C0011110100010000100100001000010010C1
11110111C1000011000010111001100000000001
10010100011110010111100C1001000110011101
1000010111C1000000000001100001000C000001
1000010010010001000000000011110000000011
1001010011000111000111011000000111100011
1001011001001100000001000000000100100011
11C1001001100000000101000000000100000001
1111001000001000011111011100001111001101
100000000111100111C000000100111C000010E1
1111111111111111111111111111111111111111
